0 0 0 0 0 0 0 0 0 0 0 0 0 0 0 0 0 0 0 0 0 0 0 0 0 0
0 0 0 0 0 0 0 0 0 0 0 0 0 0 0 0 0 0 0 0 0 0 0 0 0 0
0 0 2 2 0 0 2 2 0 0 2 2 0 0 2 2 0 0 2 2 0 0 2 2 0 0
0 0 2 2 0 0 2 2 0 0 2 2 0 0 2 2 0 0 2 2 0 0 2 2 0 0
0 0 2 2 0 0 2 2 0 0 2 2 0 0 2 2 0 0 2 2 0 0 2 2 0 0
0 0 2 2 0 0 2 2 0 0 2 2 0 0 2 2 0 0 2 2 0 0 2 2 0 0
0 0 2 2 0 0 2 2 0 0 2 2 4 4 2 2 0 0 2 2 0 0 2 2 0 0
0 0 2 2 0 0 2 2 0 0 2 2 4 4 2 2 0 0 2 2 0 0 2 2 0 0
0 0 2 2 0 0 2 2 0 0 2 2 0 0 2 2 0 0 2 2 0 0 2 2 0 0
0 0 2 2 0 0 2 2 0 0 0 0 5 5 5 0 0 0 2 2 0 0 2 2 0 0
0 0 2 2 0 0 2 2 0 0 0 5 5 5 0 0 0 0 2 2 0 0 2 2 0 0
0 0 0 0 0 0 0 0 0 0 2 2 0 0 2 2 0 0 0 0 0 0 0 0 0 0
0 0 0 0 0 0 0 0 0 0 2 2 0 0 2 2 0 0 0 0 0 0 0 0 0 0
0 0 0 0 2 2 2 2 0 0 0 0 0 0 0 0 0 0 2 2 2 2 0 0 0 0
4 4 0 0 2 2 2 2 0 0 0 0 0 0 0 0 0 0 2 2 2 2 0 0 4 4
0 0 0 0 0 0 0 0 0 0 2 2 0 0 2 2 0 0 0 0 0 0 0 0 0 0
0 0 0 0 0 0 0 0 0 0 2 2 2 2 2 2 0 0 0 0 0 0 0 0 0 0
0 0 2 2 0 0 2 2 0 0 2 2 2 2 2 2 0 0 2 2 0 0 2 2 0 0
0 0 2 2 0 0 2 2 0 8 2 2 0 0 2 2 0 0 2 2 0 0 2 2 0 0
0 0 2 2 0 0 2 2 8 8 2 2 0 0 2 2 0 0 2 2 0 0 2 2 0 0
0 0 2 2 0 0 2 2 8 8 2 2 0 0 2 2 0 0 2 2 0 0 2 2 0 0
0 0 2 2 0 0 2 2 8 8 0 0 0 0 0 0 0 0 2 2 0 0 2 2 0 0
0 0 2 2 0 0 2 2 8 8 0 0 0 0 0 0 0 0 2 2 0 0 2 2 0 0
0 0 2 2 0 0 2 2 8 8 0 2 2 2 2 0 0 0 2 2 0 0 2 2 0 0
0 0 0 0 0 0 0 0 0 0 0 2 11 12 2 0 0 0 0 0 0 0 0 0 0 0
0 0 0 0 0 0 0 0 0 0 0 2 9 10 2 0 0 0 0 0 0 0 0 0 0 0